12 12 11 11 10 9 8 7 7 6 6 6 6 6 7 7 8 8 9 9 9 10 10 10 10 9 9 8 8 7 7 6 6 6 6 6 6 5 5 5 4 4 3 3 3 3 3 3 3 3
11 11 11 10 10 9 8 8 7 7 6 6 6 6 7 7 8 8 9 9 10 10 10 10 10 9 9 8 8 7 7 7 6 6 6 6 6 6 5 5 4 4 4 3 3 3 3 3 3 4
11 11 10 10 10 9 8 8 8 7 7 7 7 7 7 8 8 9 9 10 10 10 10 10 10 10 9 9 8 8 7 7 7 7 7 7 6 6 6 5 5 5 4 4 4 4 4 4 4 4
10 10 10 9 9 9 9 9 8 8 8 8 8 8 9 9 9 9 10 10 10 10 11 11 10 10 10 9 9 8 8 8 7 7 7 7 7 7 7 6 6 6 6 5 5 5 5 5 5 5
8 9 9 9 9 9 9 9 10 10 10 10 10 10 10 10 10 10 11 11 11 11 11 11 11 11 10 10 10 9 9 9 8 8 8 8 8 8 8 7 7 7 7 7 7 7 7 7 6 6
7 7 7 8 8 9 10 10 11 11 12 12 12 12 12 12 12 12 12 12 12 12 12 12 12 11 11 11 11 10 10 10 9 9 9 9 9 9 9 9 9 9 9 9 9 9 9 8 8 7
6 6 6 7 8 9 10 11 12 13 13 14 13 13 13 13 13 13 13 13 12 12 12 12 12 12 12 12 11 11 11 11 10 10 10 10 10 10 10 10 10 10 11 11 11 11 10 10 9 8
4 4 5 6 7 9 10 12 13 14 15 15 15 15 15 15 14 14 14 13 13 13 13 13 13 13 13 13 12 12 12 12 12 11 11 11 12 12 12 12 12 12 12 12 12 12 12 11 11 10
3 3 4 5 7 9 11 13 14 16 16 17 17 17 16 16 15 15 15 14 14 14 14 14 14 14 13 13 13 13 13 13 12 12 12 12 13 13 13 13 13 14 14 14 14 14 14 13 12 11
2 2 3 4 6 8 11 13 15 17 18 18 18 18 17 17 16 16 15 15 15 14 14 14 14 14 14 14 14 13 13 13 13 13 13 13 13 14 14 14 14 15 15 15 15 15 15 14 13 11
1 1 2 4 6 8 11 13 16 17 18 19 19 18 18 18 17 16 16 15 15 15 15 15 14 14 14 14 14 14 14 14 14 14 14 14 14 14 14 15 15 15 16 16 16 16 15 15 13 12
1 1 2 4 6 8 11 13 16 17 19 19 19 19 18 18 17 17 16 15 15 15 15 15 15 15 14 14 14 14 14 14 14 14 14 14 14 14 15 15 15 16 16 16 16 16 16 15 14 12
1 1 2 4 6 8 11 13 16 17 19 19 19 19 18 18 17 17 16 15 15 15 15 15 15 14 14 14 14 14 14 14 14 14 14 14 14 14 15 15 15 16 16 16 16 16 16 15 13 12
1 1 2 4 6 8 11 13 15 17 18 19 19 18 18 18 17 16 16 15 15 15 15 15 14 14 14 14 14 14 14 14 14 14 14 14 14 14 14 14 15 15 15 15 15 15 15 14 13 11
1 1 2 4 6 8 11 13 15 17 18 18 18 18 18 17 17 16 16 15 15 15 14 14 14 14 14 14 14 14 13 13 13 13 13 13 13 13 13 14 14 14 14 14 14 14 13 13 12 11
1 2 2 4 6 8 10 13 14 16 17 17 17 17 17 17 16 16 15 15 15 14 14 14 14 14 14 14 14 13 13 13 13 13 13 13 13 13 13 13 12 12 12 12 12 12 12 11 10 9
1 2 3 4 6 8 10 12 14 15 16 16 16 16 16 16 16 15 15 15 14 14 14 14 14 14 14 13 13 13 13 13 12 12 12 12 12 12 12 11 11 11 10 10 10 10 10 9 9 8
2 2 3 4 6 8 10 11 13 14 15 16 16 15 15 15 15 15 15 14 14 14 14 14 14 14 13 13 13 13 12 12 12 12 12 12 11 11 10 10 9 9 8 8 8 8 8 8 7 7
2 2 3 4 6 7 9 11 12 13 14 15 15 14 14 14 14 14 14 14 14 14 14 14 14 13 13 13 13 12 12 12 11 11 11 11 11 10 9 9 8 7 6 6 6 6 6 6 6 6
2 2 3 4 5 7 9 10 12 13 13 14 14 14 14 14 14 14 14 14 14 14 14 14 14 13 13 13 12 12 12 11 11 11 11 11 10 9 8 7 6 5 5 4 4 4 4 4 4 5
2 3 3 4 5 7 8 10 11 12 13 13 13 13 13 13 13 13 13 13 13 14 14 14 13 13 13 12 12 12 11 11 11 11 10 10 9 9 7 6 5 4 3 3 3 3 3 3 3 4
3 3 3 4 5 7 8 9 11 12 12 12 12 12 13 13 13 13 13 13 13 13 14 13 13 13 13 12 12 11 11 11 10 10 10 10 9 8 7 6 4 3 2 2 2 2 2 2 2 3
3 3 3 4 5 7 8 9 10 11 12 12 12 12 12 12 13 13 13 13 13 13 13 13 13 13 13 12 12 11 11 11 10 10 10 10 9 8 7 5 4 3 2 1 1 1 1 2 2 3
3 3 3 4 5 7 8 9 10 11 12 12 12 12 12 12 12 13 13 13 13 13 13 13 13 13 13 12 12 11 11 11 10 10 10 10 9 8 7 5 4 3 2 2 1 1 1 2 2 3
3 4 4 5 6 7 8 9 10 11 11 12 12 12 12 12 12 12 13 13 13 13 13 13 13 13 12 12 11 11 11 10 10 10 10 10 9 8 7 6 4 3 3 2 2 2 2 2 3 3
4 5 5 6 6 7 8 9 10 10 11 11 11 11 11 11 12 12 12 12 12 13 13 13 12 12 12 11 11 11 10 10 10 10 10 9 9 8 7 6 5 4 3 3 3 3 3 3 3 4
6 6 6 7 7 8 8 9 9 10 10 10 10 10 10 10 11 11 11 12 12 12 12 12 12 11 11 11 10 10 10 9 9 9 9 9 8 8 7 6 5 5 4 4 4 4 4 4 4 5
8 8 8 8 8 8 8 8 9 9 9 9 9 9 9 9 10 10 10 11 11 11 11 11 11 11 10 10 10 9 9 9 9 9 9 8 8 8 7 7 6 6 5 5 5 5 5 5 6 6
9 9 9 9 9 9 8 8 8 8 8 7 7 8 8 8 9 9 9 10 10 10 10 10 10 10 10 9 9 9 8 8 8 8 8 8 8 8 7 7 7 7 6 6 6 6 6 7 7 7
11 11 11 11 10 9 9 8 7 7 6 6 6 6 7 7 8 8 9 9 9 10 10 10 9 9 9 9 8 8 8 8 8 7 7 7 7 7 7 8 8 8 8 8 8 8 8 8 8 9
13 13 13 12 11 10 9 8 7 6 5 5 5 5 6 6 7 7 8 8 8 9 9 9 9 8 8 8 8 7 7 7 7 7 7 7 7 7 8 8 8 8 9 9 9 9 9 9 9 10
14 14 14 13 12 10 9 7 6 5 4 4 4 4 5 5 6 6 7 7 8 8 8 8 8 8 8 7 7 7 7 7 7 6 6 7 7 7 8 8 9 9 10 10 10 10 10 10 10 11
15 15 15 14 12 11 9 7 6 4 4 3 3 4 4 5 5 6 6 7 7 8 8 8 8 8 7 7 7 7 6 6 6 6 6 6 7 7 8 8 9 10 10 10 11 11 11 11 11 11
16 16 15 14 12 11 9 7 5 4 3 3 3 3 4 4 5 6 6 7 7 7 8 8 7 7 7 7 7 7 6 6 6 6 6 6 7 7 8 9 9 10 10 11 11 11 11 11 11 11
16 16 15 14 12 11 9 7 6 4 4 3 3 4 4 4 5 6 6 7 7 7 8 8 8 7 7 7 7 7 6 6 6 6 6 6 7 7 8 9 9 10 10 11 11 11 11 11 11 11
16 16 15 14 13 11 9 8 6 5 4 4 4 4 5 5 5 6 7 7 7 8 8 8 8 8 8 7 7 7 7 7 7 7 7 7 7 8 8 9 9 10 10 11 11 11 11 11 11 11
16 16 15 14 13 11 10 8 7 6 5 5 5 5 6 6 6 7 7 8 8 8 8 8 8 8 8 8 8 8 8 8 8 8 8 8 8 9 9 9 10 10 10 11 11 11 11 11 11 11
16 16 15 14 13 12 11 10 8 8 7 7 7 7 7 7 8 8 8 8 8 8 9 9 9 9 9 9 9 9 9 9 9 9 9 9 9 10 10 10 10 10 10 11 11 11 11 11 11 11
16 16 15 15 14 13 12 11 10 9 9 9 9 9 9 9 9 9 9 9 9 9 9 9 9 9 9 10 10 10 11 11 11 11 11 11 11 11 11 11 11 11 10 10 10 10 11 11 11 11
16 16 15 15 14 14 13 12 12 11 11 11 11 11 11 11 11 10 10 10 10 10 10 10 10 10 10 11 11 12 12 12 13 13 13 13 13 12 12 11 11 11 11 10 10 10 10 10 11 11
16 16 16 15 15 15 14 14 14 13 13 13 13 13 13 12 12 12 11 11 10 10 10 10 10 11 11 12 12 13 14 14 15 15 15 14 14 14 13 12 12 11 11 10 10 10 10 10 10 10
16 16 16 16 16 15 15 15 15 15 15 15 15 15 15 14 13 13 12 12 11 11 11 11 11 11 12 13 14 14 15 16 16 16 16 16 15 15 14 13 12 11 11 10 10 10 10 10 10 10
16 16 16 16 16 16 16 17 17 17 17 17 17 17 16 15 15 14 13 12 12 11 11 11 11 12 13 14 14 15 16 17 17 18 18 17 17 16 15 14 12 11 11 10 10 10 10 10 10 10
16 16 16 16 16 17 17 17 18 18 18 18 18 18 17 16 15 14 13 13 12 12 11 11 12 12 13 14 15 16 17 18 18 19 19 18 17 16 15 14 13 12 11 10 10 10 10 10 10 10
16 16 16 16 17 17 17 18 18 18 19 19 19 18 18 17 16 15 14 13 12 12 11 12 12 13 13 14 15 16 17 18 19 19 19 19 18 17 16 14 13 12 11 10 10 10 10 10 10 10
16 16 16 16 16 17 17 18 18 18 19 19 19 18 18 17 16 15 14 13 12 12 11 12 12 13 13 14 15 16 17 18 19 19 19 19 18 17 16 14 13 12 11 10 10 10 10 10 10 10
16 16 16 16 16 17 17 17 18 18 18 18 18 18 17 16 15 14 14 13 12 12 11 12 12 12 13 14 15 16 17 18 19 19 19 18 18 17 15 14 13 12 11 10 10 10 10 10 10 10
15 15 16 16 16 16 16 17 17 17 17 17 17 17 16 16 15 14 13 12 12 12 11 11 12 12 13 14 15 16 17 18 18 18 18 18 17 16 15 14 13 12 11 11 11 10 10 10 10 10
15 15 15 15 15 15 15 16 16 16 16 16 16 15 15 14 14 13 13 12 12 11 11 11 12 12 13 14 15 16 16 17 17 18 17 17 17 16 15 14 13 13 12 12 11 11 11 11 11 10
15 15 15 15 15 15 14 14 14 14 14 14 14 14 14 13 13 12 12 12 11 11 11 11 11 12 13 13 14 15 16 16 16 17 17 16 16 15 15 14 14 13 13 12 12 12 12 12 11 10
