 -....--------------..................................................
......................................................................
......................................................................
......................................................................
.....................-------------------..............................
......................................................................
......................................................................
......................................................................
................................O.....................................
......................................................................
......................................................................
......................................................................
.........................................----------------------.......
....----------------------............................................
......................................................................
......................................................................
..........................------------------..........................
......................................................................
..-...................................................................
......................................................................
......................................................................
............................................-----------------.........
......................................................................
......................................................................
......................................................................
......................................................................
...---------------------------........................................
...........----------------......................................     
i.....................................................................
......................................................................
......................................................................
......................................................................
